##_##_###_##_###_#_#
_#__###_#__###_###_#
#####___#_##_____###
______#_###__###___#
###_#________#_#__##
#__##_#_##_###_#_##_
#_##__#_#__#__##_#__
###__####_##__#__##_
#____#____#_#_##__##
___###_####_#__#___#
_###___#____#__#___#
S#_#_###_#####_##__#
_#_#_#___#___##_####
_#_#_###_##___#_____
___#_#_#__##__######
##_____#_#_###_#____
#__#####_#_____#####
#__#_____####______#
#_#####_##__###____#
#F#___###_###_######
